####################################################################################################
             #######################################################################################
########### #####         ##########################################################################
### ####### ####### ##### ##########################################################################
###   ##### ####### ##### ##########################################################################
### ####### ####### ##### #############################      #######################################
### #######         ##### ############################# #### #######################################
### ##################### ############################# #### ##########       ######################
### ##################### ##################            #### ########## ##### ######################
### ##################### ################## ########## #### ########## ##### ######################
###     ################  ################## ########## #### ########## ##### ######################
####### ##               ################### ########## #### ########## ##### ######################
####### ######### ########################## ########## #### ########## #####                       
####### ######### ########################## ########## #### ########## ############# ##############
#######           ########################## ########## #### ##########  ############ ##############
################# ########################## ########## ################ ############ ##############
################# ########################## ##########  ############### ############ ##############
################# ########################## ########### ##############  ############  #############
################# ########################## ###########  ############# ############## #############
################# ########################## ############      ######## ############## #############
################# ########################## ################# ######## #####          #############
#################                            ################# ######## ########## #################
################# ############################################ ######## ########## #################
################# ############################################ ######## ##########  ################
################# ############################################ ######## ########### ################
################# ###################################                   ########### ################
################# #############       ############### ######## ### ################ ################
################# ############# ##### ############### ######## ### ##########         ##############
################# ############# ##### ############### ######### ## ################ ################
################# ############# ##### ############### ######### ## ################ ################
################# ############# ##### ############### ############################      b###########
#################               ##### ############### ##############################################
################## ################## ############### ##############################################
################## ################## ############### ##############################################
#############################               ##               #######################################
####################################################################################################
####################################################################################################
####################################################################################################
####################################################################################################
####################################################################################################
