##################################################
##################################################
##################################################
#######################            ###############
############################ #####################
############################ #####################
############################ #####################
############################ #####################
############################ #####################
#########################                    #####
######################### ################## #####
###############           ################## #####
#########################       ############ #####
###############################  ########### #####
############################### ############ #####
############################### ############ #####
############################### ############ #####
###################                 #####        e
################### ######################## #####
#############b      ######################## #####
#######   ######### ######################## #####
######### ######### ########################  ####
########        ###      #################### ####
######## ###### ### ######################### ####
######## ###### ### ######################### ####
######## ######     ######################### ####
######## #############################        ####
######## ############################## ##########
######## ############################## ##########
######## ############################## ##########
######## ############################## ##########
######## ############################## ##########
######## ############################## ##########
########  ############################# ##########
#########             #################          e
################## ###############################
################## ###############################
#################  ###############################
################# ################################
################# ################################
#                     ############################
# ################################################
# ################################################
# ################################################
#e################################################
